[8, 10]
(1, 2)
(7, 3) | (3, 6)
(0,1,5,1)
(4,2,1,2)
(0,3,3,1)
(1,5,4,1)
(1,6,1,1)
(4,6,1,1)
(3,7,1,1)
(6,1,3,1)
(6,2,1,4)
(8,3,1,2)
(7,4,1,1)
(9,5,1,1)
(8,6,1,1)
(6,7,1,1)