[5,11]
(0,3)
(7,0) | (10,3)
(2,0,2,2)
(8,0,1,2)
(10,0,1,1)
(2,3,1,2)
(3,4,3,1)
(9,3,1,1)
(8,4,2,1)
(6,0,1,1)