[5,11]
(7,0)
(0,1) | (10,0)
(2,0,2,2)
(2,3,1,2)
(3,4,3,1)
(5,1,1,1)
(6,0,1,2)
(8,0,1,4)
(9,3,1,1)
(10,1,1,1)