[5,11]
(0,0)
(10,4) | (3,2)
(2,0,1,4)
(3,1,3,1)
(3,3,3,1)
(5,2,1,1)
(7,2,1,2)
(8,2,3,1)